11111111111
1P00E00C011
11111111111
