111111111
11111E111
11111C111
11111P111
111111111
111111111
