1111111111111111111111
1000010011111000000001
10000100C0000000001111
100001001111C000000001
100001000000000000CC11
1000010011C11000001111
1P00E0C100000000000001
1000010011111000001111
1000010000110000001111
10000000CCCCC000000011
1000010011111000001011
1000010000000000001C11
1111111111111111111111
