11111111111111111111111111111111111
10000000000000000000000000000000001
10000000000000100000000000000000001
10000000000001010000000000000000001
10000000000010001000000000000000001
10000000000100C00100000000000000001
10000000001000001000000010000000001
100000000100P00100000001E1000000001
10000000100000000100000100000000001
10000001000000000010001000000000001
10000000000100000001010000000000001
11110000000000000000100000000000001
10010000000000000000000000000000001
11111111111111111111111111111111111
