1111111111111111111111
1P10CCC00110C010000E11
1010111101101010111011
1010001100001111111011
10111011111C111110CCC1
1011101000CCC000101111
1010C010111111101CCC01
1C10111010000010100101
10100010001C1C10111101
1C101011111110101100C1
10001000CCCC001000C111
1111111111111111111111
